			--------SUPPORTED GAMES AS OF 1.2---------------
			aof - Art of Fighting (GFX)
			aof2 - Art of Fighting 2 (GFX)
			aof3 - Art of Fighting 3 (GFX)
			armwar - Armoured Warriors (GFX)
			asurabus - Asura Buster (Program Data)
			avengrgs - Avengers in Galactic Storm (Program Data)
			avsp = Alien VS Predator (GFX)
			breakrev - Breakers Revenge (GFX)
			btlkroad - Battle K Road (Program Data)
			cybots - Cyberbots: Fullmetal Madness (GFX)
			dankuga - Dan-Ku-Ga (Program Data)
			ddsom - Dungeons & Dragons: Shadow Over Mystara (GFX)
			ddtod - Dungeons & Dragons: Tower of Doom (GFX)
			dino - Caddilacs and Dinosaurs (GFX+Program Data)
			dinorex - Dino Rex (Program Data)
			doubledr - Double Dragon (Neo-Geo) (GFX)
			dstlk - Darkstalkers: The Night Warriors (GFX)
			ffight - Final Fight (GFX+Program Data)
			galaxyfg - Galaxy Fight: Universal Warriors (GFX)
			garoup - Garou: Mark of the Wolves (prototype) (GFX+Program Data)
			ghouls - Ghouls 'N Ghosts (GFX+Program Data)
			gowcaizr - Voltage Fighter Gowcaizer (GFX)
			jchan - Jackie Chan: The Kung Fu Master
			kizuna - Kizuna Encounter (GFX)
			knights - Knights of the Round (GFX+Program Data)
			kof94 - King of Fighters 94 (GFX)
			kof95 - King of Fighters 95 (GFX)
			kof96 - King of Fighters 96 (GFX)
			kof97 - King of Fighters 97 (GFX)
			kof98 - King of Fighters 98 (GFX)
			lastbld2 - Last Blade 2 (GFX)
			magdrop3 - Magical Drop 3 (GFX)
			mmaulers - Monster Maulers (Program Data)
			msh - Marvel SuperHeroes (GFX)
			mshvsf - Marvel Superheroes VS Street Fighter (GFX)
			mslug - Metal Slug (GFX)
			mvsc - Marvel VS Capcom: Clash of Superheroes (GFX)
			mwarr - Mighty Warriors (Program Data)
			nwarr - Night Warriors: Darkstalkers Revenge (GFX)
			rbff2 - Real Bout: Fatal Fury 2 (GFX)
			samsho - Samurai Shodown/Samurai Spirits (GFX)
			samsho2 - Samurai Shodown 2 (GFX)
			samsho3 - Samurai Shodown 3 (GFX)
			samsho4 - Samurai Shodown 4 (GFX)
			sf - Street Fighter (Program Data)
			sf2 - Street Fighter 2: The World Warrior (GFX+Program Data)
			sfa - Street Fighter Alpha (GFX)
			sfa2 - Street Fighter Alpha 2 (GFX)
			sfa3 - Street Fighter Alpha 3 (GFX)
			sgemf - Super Gem Fighter (GFX)
			ssf2t - Super Street Fighter 2 Turbo (GFX)
			strider - Strider (GFX+Program Data)
			vhunt2 - Vampire Hunter 2 (GFX)
			vsav - Vampire Saviour: The Lord of Vampire (GFX)
			vsav2 - Vampire Saviour 2: The Lord of Vampire (GFX)
			wakuwak7 - Waku Waku 7 (GFX)
			wh1 - World Heroes 1 (GFX)
			xmcota - X-Men: Children of the Atom (GFX)
			xmvsf - X-Men VS Street Fighter (GFX)
